30 16 4
5 5 5 5 5 5 5 5 5 5 5 5 5 5 5 5 5 5 5 5 5 5 5 5 5 5 5 5 5 5
5 5 5 5 5 5 5 5 5 5 5 5 5 5 5 5 5 5 5 5 5 5 5 5 5 5 5 5 5 5
3 3 3 3 3 3 4 5 5 5 5 5 5 5 5 5 5 5 5 5 5 5 5 5 5 5 5 5 5 5
3 3 3 3 3 4 4 5 5 5 5 5 5 5 5 5 5 5 5 5 5 5 5 5 5 5 5 5 5 5
5 5 5 5 5 4 4 5 5 5 5 5 5 5 5 5 5 5 5 5 5 5 3 3 3 3 3 3 3 3
5 5 5 5 5 4 4 5 5 5 5 5 5 5 5 5 5 5 5 5 5 5 2 3 3 3 3 3 3 3
5 5 5 5 5 4 4 5 5 5 5 5 5 5 5 5 5 5 5 5 5 5 2 2 5 5 5 5 5 5
5 5 5 5 5 4 4 5 5 5 5 5 5 5 5 5 5 5 5 5 5 5 2 2 5 5 5 5 5 5
5 5 5 5 5 4 4 5 5 5 5 5 5 5 5 5 5 3 3 3 3 3 2 2 5 5 5 5 5 5
5 5 5 5 5 4 4 5 5 5 5 5 5 5 5 5 5 2 3 3 3 3 3 2 5 5 5 5 5 5
5 5 5 5 5 4 4 5 5 5 5 5 5 5 5 5 5 2 2 5 5 5 5 5 5 5 5 5 5 5
5 5 5 5 5 4 4 5 5 5 5 5 5 5 5 5 5 2 2 5 5 5 5 5 5 5 5 5 5 5
5 5 5 5 5 4 4 5 5 5 5 5 5 5 5 5 5 2 2 5 5 5 5 5 5 5 5 5 5 5
5 5 5 5 5 4 3 3 3 3 3 3 3 3 3 3 3 2 2 5 5 5 5 5 5 5 5 5 5 5
5 5 5 5 5 3 3 3 3 3 3 3 3 3 3 3 3 3 2 5 5 5 5 5 5 5 5 5 5 5
5 5 5 5 5 5 5 5 5 5 5 5 5 5 5 5 5 5 5 5 5 5 5 5 5 5 5 5 5 5
Target 29 4 1 2 20
NormalSpawner 0 2 1 2 45 90 20
BossSpawner 0 2 1 2 45 90 2
SmallerSpawner 0 2 1 2 45 50 40